NO ./maps/wall1.xpm
SO ./maps/wall2.xpm
WE ./maps/wall3.xpm
EA ./maps/wall4.xpm

F 100,100,100
C 0,0,0

11111111111111111111111111111111111111111111111111
101           100000000000000000000000000000000001
10011111111111001000000000000000000000000000000001
10000000100N00000000000000000000000000000000000001
10000000000000000000000000000000000000000000000001
10000011000011000000000000000000000000000000000001
10000000000011000000000000000000000000000000000001
10000010000100000000000000000000000000000000000001
10000010000100000001000000000000000000000000000001
10000010000100000001000000000000000000000000000001
10000010000100000001000000000000000000000000000001
10000010000100000001000000000000000000000000000001
11111111111111111111111111111111111111111111111111
